|||||||||||||||||||||||||||||||||||||||||
|__*******|*******|*********|***|*******|
|_|||||||||*|||||*|*|||||||*|*|*|*|||||*|
|*|*|*******|*|***|*|***|***|*|*|*****|*|
|*|*|*|||||||*|*|||*|*|*|*|||*|*|*|*|*|*|
|*|*******|*|*****|*|*|*******|*|*|*|*|*|
|*|||||||*|*|||*|*|*|*|*|||||||*|*|*|*|*|
|*********|*****|***|*|*******|***|*|*|*|
|||||||||||||*|||*|||*|||||||*|*|||*|*|||
|*********|*******|*|***|*****|*|*|*|***|
|*|||||||||*|*|||*|*|||*|*|||||*|*|*|||*|
|***********|*|***|***|*|*****|*****|***|
|||||||||*|||*|*|||||*|*|||||||*|||||*|||
|*****|*****|*|*****|*|*********|***|***|
|*|*|||*|||||*|||||*|*|||||||||||||*|||*|
|*|***|*******|*****|*|***|***|*********|
|*|||*|||||||||*|*|||*|*|||*|||*|||*|||||
|*|*|*|*********|*****|***|***|***|*****|
|*|*|*|||*|||||*|||*|||||*|||*|*|*|||||*|
|***|***|*|***|***|***|*|*|***|*|*****|*|
|||||||*|*|*|*|*|*|||*|*|*|*|*|*|||*|*|*|
|***|*****|*|***|*|*|*****|*|***|***|*|*|
|*|*|||*|||*|||||*|*|||*|||||||||*|||*|||
|*|*|***|***|*|***|***|***|*******|*****|
|*|*|*|||*|||*|*|||||*|||||*|||||||||||*|
|*|*|*****|*****|***|*|*|***|***|***|*|*|
|*|*|||||||*|||||*|*|*|*|*|||*|*|*|*|*|*|
|*|*********|*****|*|*****|***|*|*|*|***|
|*|||||||||*|*|||||*|||||||||*|*|*|||*|||
|*****|***|*|***|***|*********|***|*****|
|||||*|*|*|*|||*|*|||*|||*|||||||||*|||*|
|*****|*|*|***|*|***|***|***********|*|*|
|*|||||*|*|||*|*|||||||*|||||||||||||*|*|
|*******|*|***|*****|*****|***|***|***|*|
|||||||||*|*|||||||*|*|||||*|*|*|*|*|||*|
|*****|***|*****************|*|*|*|*|***|
|*|||||*|||||*|||||*|||||||||*|*|*|*|*|||
|*******|***|*|*****|*******|***|*|***|*|
|||*|||||||*|*|*|||||||||||*|||||*|||||_|
|***********|*|*************|*********__|
|||||||||||||||||||||||||||||||||||||||||