|||||||||||||||||||||||||||||||||||||||||
_*********|*******|*********|***|*******|
|*|||||||||*|||||*|*|||||||*|*|*|*|||||*|
|*|*|*******|*|***|*|***|***|*|*|*|***|*|
|*|*|*|||||||*|*|||*|*|*|*|||*|*|*|*|*|*|
|*|*******|*|*****|*|*|*|*****|*|*|*|*|*|
|*|||||||*|*|||*|*|*|*|*|||||||*|*|*|*|*|
|*********|*****|***|*|*******|***|*|*|*|
|||||||||||||*|||||||*|||||||*|*|||*|*|||
|*********|*******|*|***|*****|*|*|*|***|
|*|||||||||*|*|||*|*|||*|*|||||*|*|*|||*|
|***********|*|***|***|*|*****|*****|***|
|||||||||||||*|*|||||*|*|||||||*|||||*|||
|*****|*****|*|*****|*|*********|***|***|
|*|*|||*|||||*|||||*|*|||||||||||||*|||*|
|*|***|*******|*****|*|***|***|*********|
|*|||*|||||||||*|*|||*|*|||*|||*|||*|||||
|*|*|*|*********|*****|***|***|***|*****|
|*|*|*|||*|||||||||*|||||*|||*|*|*|||||*|
|***|***|*|***|***|***|*|*|***|*|*****|*|
|||||||*|*|*|*|*|*|||*|*|*|*|*|*|||*|*|*|
|***|*****|*|***|*|*|*****|*|***|***|*|*|
|*|*|||*|||*|||||*|*|||*|||||||||*|||*|||
|*|*|***|***|*|***|***|***|*******|*****|
|*|*|*|||*|||*|*|||||*|||||*|||||||||||*|
|*|*|*****|*****|***|*|*|***|***|***|*|*|
|*|*|||||||||||||*|*|*|*|*|||*|*|*|*|*|*|
|*|*********|*****|*|*****|***|*|*|*|***|
|*|||||||||*|*|||||*|||||||||*|*|*|||*|||
|*****|***|*|***|***|*********|***|*****|
|||||*|*|*|*|||*|*|||*|||*|||||||||*|||*|
|*****|*|*|***|*|***|***|***********|*|*|
|*|||||*|*|||*|*|||||||*|||||||||||||*|*|
|*******|*|***|*****|*****|***|***|***|*|
|||||||||*|*|||||||*|*|||||*|*|*|*|*|||*|
|*****|***|*****************|*|*|*|*|***|
|*|||||*|||||*|||||*|||||||||*|*|*|*|*|||
|*******|***|*|*****|*******|***|*|***|*|
|||*|||||||*|*|*|||||||||||*|||||*|||||*|
|***********|*|*************|***********_
|||||||||||||||||||||||||||||||||||||||||